public class Levels {
	//From Game class
	public static int[][] board = Game.board;
	public static int level = Game.level;
	/*Each level method includes:
	1) Increase level displayed (level++)
	2) Put all the nums into board
	3) Count ICE & NEXT_LEVEL slots*/

	public static boolean level1() { //Layout
    	boolean next = false;
    	level++;
    	//Put temp back into board after each movement

    	board = new int[][] { //15x19
        	{2, 2, 2, 2, 2, 2, 2, 2, 2, 2, 2, 2, 2, 2, 2, 2, 2, 2, 2},
        	{2, 2, 2, 2, 2, 2, 2, 2, 2, 2, 2, 2, 2, 2, 2, 2, 2, 2, 2},
        	{2, 2, 2, 2, 2, 2, 2, 2, 2, 2, 2, 2, 2, 2, 2, 2, 2, 2, 2},
        	{2, 2, 2, 2, 2, 2, 2, 2, 2, 2, 2, 2, 2, 2, 2, 2, 2, 2, 2},
        	{2, 2, 2, 2, 2, 2, 2, 2, 2, 2, 2, 2, 2, 2, 2, 2, 2, 2, 2},
        	{2, 2, 2, 2, 2, 2, 2, 2, 2, 2, 2, 2, 2, 2, 2, 2, 2, 2, 2},
        	{2, 2, 2, 2, 2, 2, 2, 2, 2, 2, 2, 2, 2, 2, 2, 2, 2, 2, 2},
        	{2, 2, 2, 2, 2, 2, 2, 2, 2, 2, 2, 2, 2, 2, 2, 2, 2, 2, 2},
        	{2, 2, 2, 2, 2, 2, 2, 2, 2, 2, 2, 2, 2, 2, 2, 2, 2, 2, 2},
        	{3, 3, 3, 3, 3, 3, 3, 3, 3, 3, 3, 3, 3, 3, 3, 3, 3, 3, 3}, //*
        	{3, 3, 6, 4, 4, 4, 4, 4, 4, 4, 4, 4, 4, 4, 4, 4, 4, 1, 3}, //*
        	{3, 3, 3, 3, 3, 3, 3, 3, 3, 3, 3, 3, 3, 3, 3, 3, 3, 3, 3}, //*
        	{2, 2, 2, 2, 2, 2, 2, 2, 2, 2, 2, 2, 2, 2, 2, 2, 2, 2, 2},
        	{2, 2, 2, 2, 2, 2, 2, 2, 2, 2, 2, 2, 2, 2, 2, 2, 2, 2, 2},
        	{2, 2, 2, 2, 2, 2, 2, 2, 2, 2, 2, 2, 2, 2, 2, 2, 2, 2, 2}};
    	/*for(int r = 0; r < board.length; r++) {
    	for(int c = 0; c < board[0].length; c++) {
    	System.out.println(board[r][c]);
    	}
    	}*/

    	// Stats.countDenominator();
    	/*//Wall blocker/boarder
    	for(int r = 15; r < board.length-3; r++) { //15 to 17
    	for(int c = 1; c < board[0].length-3; c++) { //1 to 22
    	board[r][c] = WALL_BLOCKER;
    	}
    	}

    	//Ice
    	for(int r = 16; r < 17; r++) {
    	for(int c = 2; c < 22; c++) { //board[0].length-4
    	board[r][c] = ICE;
    	}
    	}

    	//Next level
    	for(int r = 16; r < 17; r++) {
    	for(int c = 2; c < 3; c++) {
    	board[r][c] = NEXT_LEVEL;
    	}
    	}*/
    	return next;
	}

	public static void level2() {
    	level++;
    	board = new int[][] {//Change to board =
        	{2, 2, 2, 2, 2, 2, 2, 2, 2, 2, 2, 2, 2, 2, 2, 2, 2, 2, 2},
        	{2, 2, 2, 2, 2, 2, 2, 2, 2, 2, 2, 2, 2, 2, 2, 2, 2, 2, 2},
        	{2, 2, 2, 2, 2, 2, 2, 2, 2, 2, 2, 2, 2, 2, 2, 2, 2, 2, 2},
        	{2, 2, 2, 2, 2, 2, 2, 2, 2, 2, 2, 2, 2, 2, 2, 2, 2, 2, 2},
        	{2, 2, 2, 2, 2, 2, 2, 2, 2, 2, 2, 2, 2, 2, 2, 2, 2, 2, 2},
        	{2, 2, 2, 2, 2, 2, 2, 2, 2, 2, 2, 2, 2, 2, 2, 2, 2, 2, 2},
        	{2, 2, 2, 2, 2, 2, 2, 2, 2, 2, 2, 2, 2, 3, 3, 3, 2, 2, 2},
        	{2, 2, 2, 2, 2, 2, 2, 2, 2, 2, 2, 2, 2, 3, 6, 3, 2, 2, 2},
        	{2, 2, 2, 2, 2, 2, 2, 2, 2, 2, 2, 2, 2, 3, 4, 3, 2, 2, 2},
        	{2, 3, 3, 3, 3, 3, 3, 3, 2, 3, 3, 3, 3, 3, 4, 3, 2, 2, 2},
        	{2, 3, 1, 4, 4, 4, 4, 3, 2, 3, 4, 4, 4, 4, 4, 3, 2, 2, 2},
        	{2, 3, 3, 3, 3, 3, 4, 3, 3, 3, 4, 3, 3, 3, 3, 3, 2, 2, 2},
        	{2, 2, 2, 2, 2, 3, 4, 4, 4, 4, 4, 3, 2, 2, 2, 2, 2, 2, 2},
        	{2, 2, 2, 2, 2, 3, 3, 3, 3, 3, 3, 3, 2, 2, 2, 2, 2, 2, 2},
        	{2, 2, 2, 2, 2, 2, 2, 2, 2, 2, 2, 2, 2, 2, 2, 2, 2, 2, 2}};
    	Stats.countDenominator();
	}

	public static void level3() {
    	level++;
    	board = new int[][] {
        	{2, 2, 2, 2, 2, 2, 2, 2, 2, 2, 2, 2, 2, 2, 2, 2, 2, 2, 2},
        	{2, 2, 2, 2, 2, 2, 2, 2, 2, 2, 2, 2, 2, 2, 2, 2, 2, 2, 2},
        	{2, 2, 2, 2, 2, 2, 2, 2, 2, 2, 2, 2, 2, 2, 2, 2, 2, 2, 2},
        	{2, 2, 2, 2, 2, 2, 2, 2, 2, 2, 2, 2, 2, 2, 2, 2, 2, 2, 2},
        	{2, 2, 2, 2, 2, 2, 2, 2, 2, 2, 2, 2, 2, 2, 2, 2, 2, 2, 2},
        	{2, 2, 2, 2, 2, 2, 2, 2, 2, 2, 2, 2, 2, 2, 2, 2, 2, 2, 2},
        	{2, 2, 3, 3, 3, 2, 2, 2, 2, 2, 2, 2, 2, 3, 3, 3, 2, 2, 2},
        	{2, 2, 3, 6, 3, 2, 2, 2, 2, 2, 2, 2, 2, 3, 1, 3, 2, 2, 2},
        	{2, 2, 3, 4, 3, 3, 3, 3, 3, 2, 2, 2, 2, 3, 4, 3, 2, 2, 2},
        	{2, 2, 3, 4, 3, 3, 4, 4, 3, 3, 3, 3, 3, 3, 4, 3, 2, 2, 2},
        	{2, 2, 3, 4, 4, 4, 4, 4, 4, 4, 4, 4, 4, 4, 4, 3, 2, 2, 2},
        	{2, 2, 3, 4, 4, 3, 3, 3, 3, 4, 4, 3, 3, 4, 4, 3, 2, 2, 2},
        	{2, 2, 3, 3, 3, 3, 2, 2, 3, 3, 3, 3, 3, 3, 3, 3, 2, 2, 2},
        	{2, 2, 2, 2, 2, 2, 2, 2, 2, 2, 2, 2, 2, 2, 2, 2, 2, 2, 2},
        	{2, 2, 2, 2, 2, 2, 2, 2, 2, 2, 2, 2, 2, 2, 2, 2, 2, 2, 2}};
    	Stats.countDenominator();
	}

	public static void level4() {
    	level++;
    	board = new int[][] {
        	{2, 2, 2, 2, 2, 2, 2, 2, 2, 2, 2, 2, 2, 2, 2, 2, 2, 2, 2},
        	{2, 3, 3, 3, 3, 3, 2, 2, 2, 2, 2, 2, 3, 3, 3, 3, 3, 2, 2},
        	{2, 3, 4, 4, 4, 3, 3, 3, 3, 3, 3, 3, 3, 4, 4, 4, 3, 2, 2},
        	{2, 3, 4, 3, 4, 3, 3, 4, 4, 4, 4, 3, 3, 4, 3, 4, 3, 2, 2},
        	{2, 3, 4, 4, 4, 4, 4, 4, 4, 4, 4, 4, 4, 4, 4, 4, 3, 2, 2},
        	{2, 3, 3, 4, 3, 3, 3, 3, 4, 4, 3, 3, 3, 3, 4, 3, 3, 2, 2},
        	{2, 2, 3, 4, 3, 2, 3, 4, 4, 4, 4, 3, 2, 3, 4, 3, 2, 2, 2},
        	{2, 2, 3, 1, 3, 2, 3, 4, 4, 4, 4, 3, 2, 3, 6, 3, 2, 2, 2},
        	{2, 2, 3, 3, 3, 2, 3, 3, 3, 3, 3, 3, 2, 3, 3, 3, 2, 2, 2},
        	{2, 2, 2, 2, 2, 2, 2, 2, 2, 2, 2, 2, 2, 2, 2, 2, 2, 2, 2},
        	{2, 2, 2, 2, 2, 2, 2, 2, 2, 2, 2, 2, 2, 2, 2, 2, 2, 2, 2},
        	{2, 2, 2, 2, 2, 2, 2, 2, 2, 2, 2, 2, 2, 2, 2, 2, 2, 2, 2},
        	{2, 2, 2, 2, 2, 2, 2, 2, 2, 2, 2, 2, 2, 2, 2, 2, 2, 2, 2},
        	{2, 2, 2, 2, 2, 2, 2, 2, 2, 2, 2, 2, 2, 2, 2, 2, 2, 2, 2},
        	{2, 2, 2, 2, 2, 2, 2, 2, 2, 2, 2, 2, 2, 2, 2, 2, 2, 2, 2}};
    	Stats.countDenominator();
	}

	public static void level5() {
    	level++;
    	board = new int[][] {
        	{2, 2, 2, 2, 2, 2, 2, 2, 2, 2, 2, 2, 2, 2, 2, 2, 2, 2, 2},
        	{2, 2, 2, 2, 2, 2, 2, 2, 2, 2, 2, 2, 2, 2, 2, 2, 2, 2, 2},
        	{2, 2, 2, 2, 2, 2, 2, 2, 2, 2, 2, 2, 2, 2, 2, 2, 2, 2, 2},
        	{2, 2, 2, 2, 2, 2, 2, 2, 2, 2, 2, 2, 2, 2, 2, 2, 2, 2, 2},
        	{2, 2, 2, 2, 2, 2, 2, 2, 2, 2, 2, 2, 2, 2, 2, 2, 2, 2, 2},
        	{2, 2, 2, 2, 2, 2, 2, 2, 2, 2, 2, 2, 2, 2, 2, 2, 2, 2, 2},
        	{2, 2, 2, 2, 2, 2, 2, 2, 2, 2, 2, 2, 2, 3, 3, 3, 2, 2, 2},
        	{2, 2, 2, 2, 2, 2, 2, 2, 2, 2, 2, 2, 2, 3, 1, 3, 2, 2, 2},
        	{2, 2, 2, 3, 3, 3, 3, 3, 3, 3, 3, 3, 3, 3, 2, 3, 3, 3, 2},
        	{2, 3, 3, 3, 2, 2, 2, 2, 2, 2, 2, 2, 2, 2, 2, 2, 2, 3, 2},
        	{2, 3, 6, 2, 2, 2, 2, 2, 2, 2, 2, 2, 2, 2, 2, 2, 2, 3, 2},
        	{2, 3, 3, 3, 3, 2, 2, 2, 2, 2, 2, 2, 2, 2, 2, 2, 2, 3, 2},
        	{2, 2, 2, 2, 3, 3, 3, 3, 3, 3, 3, 3, 3, 3, 3, 3, 3, 3, 2},
        	{2, 2, 2, 2, 2, 2, 2, 2, 2, 2, 2, 2, 2, 2, 2, 2, 2, 2, 2},
        	{2, 2, 2, 2, 2, 2, 2, 2, 2, 2, 2, 2, 2, 2, 2, 2, 2, 2, 2}};
    	Stats.countDenominator();
	}

	public static void level6() {
    	board = new int[][] {
        	{2, 2, 2, 2, 2, 2, 2, 2, 2, 2, 2, 2, 2, 2, 2, 2, 2, 2, 2},
        	{2, 2, 2, 2, 2, 2, 2, 2, 2, 2, 2, 2, 2, 2, 2, 2, 2, 2, 2},
        	{2, 2, 2, 2, 2, 2, 2, 2, 2, 2, 2, 2, 2, 2, 2, 2, 2, 2, 2},
        	{2, 2, 2, 2, 2, 2, 2, 2, 2, 2, 2, 2, 2, 2, 2, 2, 2, 2, 2},
        	{2, 2, 2, 2, 2, 2, 2, 2, 2, 2, 2, 2, 2, 2, 2, 2, 2, 2, 2},
        	{2, 2, 2, 2, 2, 2, 2, 2, 2, 2, 2, 2, 2, 2, 2, 2, 2, 2, 2},
        	{2, 2, 2, 2, 2, 2, 2, 2, 2, 2, 2, 2, 2, 3, 3, 3, 2, 2, 2},
        	{2, 2, 2, 2, 2, 2, 2, 2, 2, 2, 2, 2, 2, 3, 6, 3, 2, 2, 2},
        	{2, 2, 2, 2, 3, 3, 3, 3, 3, 3, 3, 3, 3, 3, 4, 3, 3, 3, 2},
        	{2, 3, 3, 3, 3, 4, 4, 4, 3, 4, 4, 4, 4, 3, 4, 4, 4, 3, 2},
        	{2, 3, 1, 4, 4, 4, 4, 4, 4, 4, 4, 4, 4, 3, 4, 4, 4, 3, 2},
        	{2, 3, 3, 3, 4, 4, 4, 4, 4, 4, 4, 4, 4, 4, 4, 4, 4, 3, 2},
        	{2, 2, 2, 3, 3, 3, 3, 4, 4, 4, 3, 3, 3, 3, 3, 3, 3, 3, 2},
        	{2, 2, 2, 2, 2, 2, 3, 3, 3, 3, 3, 2, 2, 2, 2, 2, 2, 2, 2},
        	{2, 2, 2, 2, 2, 2, 2, 2, 2, 2, 2, 2, 2, 2, 2, 2, 2, 2, 2}};
	}

	public static void level7() {
    	board = new int[][] {
        	{2, 2, 2, 2, 2, 2, 2, 2, 2, 2, 2, 2, 2, 2, 2, 2, 2, 2, 2},
        	{2, 2, 2, 2, 2, 2, 2, 2, 2, 2, 2, 2, 2, 2, 2, 2, 2, 2, 2},
        	{2, 3, 3, 3, 3, 3, 3, 3, 3, 3, 3, 3, 3, 3, 3, 3, 2, 2, 2},
        	{2, 3, 4, 4, 4, 4, 4, 4, 4, 4, 4, 4, 4, 4, 4, 3, 2, 2, 2},
        	{2, 3, 4, 3, 3, 3, 3, 3, 3, 3, 3, 3, 3, 3, 4, 3, 3, 3, 3},
        	{2, 3, 4, 3, 3, 3, 6, 4, 4, 4, 4, 4, 4, 4, 1, 4, 4, 4, 3},
        	{2, 3, 4, 3, 3, 3, 3, 3, 3, 3, 3, 3, 3, 3, 2, 3, 3, 4, 3},
        	{2, 3, 4, 3, 3, 3, 3, 3, 3, 3, 3, 3, 3, 3, 2, 3, 3, 4, 3},
        	{2, 3, 4, 3, 3, 3, 3, 3, 3, 3, 3, 3, 3, 3, 3, 3, 3, 4, 3},
        	{2, 3, 4, 3, 3, 4, 4, 4, 4, 3, 3, 4, 4, 3, 3, 3, 3, 4, 3},
        	{2, 3, 4, 4, 4, 4, 4, 4, 4, 4, 4, 4, 4, 4, 4, 4, 4, 4, 3},
        	{2, 3, 3, 3, 3, 3, 3, 3, 4, 4, 4, 4, 4, 4, 3, 3, 3, 3, 3},
        	{2, 2, 2, 2, 2, 2, 2, 3, 3, 3, 3, 3, 3, 3, 3, 2, 2, 2, 2},
        	{2, 2, 2, 2, 2, 2, 2, 2, 2, 2, 2, 2, 2, 2, 2, 2, 2, 2, 2},
        	{2, 2, 2, 2, 2, 2, 2, 2, 2, 2, 2, 2, 2, 2, 2, 2, 2, 2, 2}};
	}

	public static void level8() {}

	public static void level9() {}

	public static void level10() {}
}